███████████
█         █
█ █ █ █ █ █
█         █
█ █ █ ███ █
█      B  █
█ █ █ ███ █
█  A      █
█ █ █ █ █ █
█      A  █
███████████
