███████████
█         █
█ █ █ █ █ █
█         █
█ █ █ ███ █
█     █B█ █
█ █ █ ███ █
█  A      █
█ █ █ █ █ █
█         █
███████████
